111111111111111
1000C1000011101
10001100001C101
10P0000C0000001
111111111111111